자장면 1 인분 배달 가능한가요 ?	죄송하지만 2 인분 주문 하셔야 배달 가능합니다
1 인분 도 배달 가능한가요	물론 입니다
짜장면 한 그릇 도 배달 되나요 ?	아니요 만 원 되어야지 배달 가능합니다
짜장면 1 인분 배달 가능한가요 ?	죄송하지만 1 인분 은 배달 이 안 됩니다
한 그릇 도 주문 가능한가요 ?	주문 해주세요
짜장면 1 인분 만 배달 가능한가요 ?	가능한데 배달 료 붙습니다
수고 하십니다 죄송하지만 배달 은 2 인분 가능하죠 ?	주문 단위 인분 이 아니고 저희 는 한 마리 요
맛있게 해주세요	단골 이신 데 당연하지요
아셨어요 ?	자주 주문 헤드 시 는 분 이라고 뜨네요
요 ?	양념치킨 용 양념 이 다 떨어져서요
주문 할게요	알겠습니다
짜장면 한 그릇 에요 ?	4000원 입니다
불고기 피자 치킨 세트 인가요 ?	21900원 입니다
치킨 무 1 개 더 추가 하면 추가 금액 이 에요 ?	개당 500원 입니다
프라이드 한 마리 에요 ?	15000원 입니다
탕수육 중 자 예요 ?	만 오천 원 입니다
하와 이안 피자 라지 는 얼 만 가요 ?	이만 삼천 원 입니다
에요 ?	21000원 입니다
짬뽕 하나 간짜장 탕수육 작은 거 시키려는데 죠 ?	27000원 입니다
프라이드 치킨 한 마리 인가요 ?	16000원 입니다
그건 예요 ?	15000원 입니다
짜장면 한 그릇 에요 ?	5500원 입니다
프라이드 양념 반 반 치킨 가격 되나요 ?	20000원 입니다
홍합 짬뽕 은 인가요 ?	6500원 입니다
콜라 큰 거 추가 하면 인가요 ?	오늘 은 서비스 드릴게요
그냥 짜장면 곱빼기 하나 는 가격 이 인가요	5천 원 입니다
16000원 맞죠	손님 죄송한데 저희 세트 가격 올리게 돼서 20000원 입니다
추가 하려면 인가요 ?	500원 씩이에요
빅맥 세트 에요 ?	6300원 입니다
짜장면 가격 이 죠 ?	6000원 입니다
짜장면 탕수육 세트 는 인가요 ?	13000원 입니다 .
짜장면 한 그릇 인가요 ?	4500원 입니다 .
프라이드 는 예요 ?	만 원 입니다
추가 스파게티 주문 하려는데 크림소스 스파게티 하나 하나요 ?	7800원 입니다
황금 올리브 속 안심 하나 인가요 ?	17000원 입니다
총 인가요 ?	총 15500원 입니다 .
탕수육 소 짜 리 는 죠 ?	15000원 입니다
볶음밥 은 인가요 ?	6000원 입니다
가격 이 되죠 ?	총 2만 3천 원 입니다 .
짜장면 한 그릇 에요 ?	4000원 입니다
총 인가요 ?	3만 5천 원 입니다
인가요 ?	22000원 입니다
슈프림 피자 미디엄 사이즈 가격 알 수 있을까요 ?	만 오천 원 입니다 .
짜장면 한 그릇 에요 ?	6000원 입니다
가격 은 인가요 ?	삼만 원 입니다
팝콘 치킨 하고 프라이드 치킨 합 해서 죠 ?	31000원 입니다
팝콘 치킨 은 죠 ?	12000원 입니다
짜장면 한 그릇 인가요 ?	4500원 입니다
미트볼 스파게티 는 죠 ?	6000원 이요
슈 림프 핫 치킨 골드 피자 는 31000원 이네요 ?	라지 31000원 입니다
고구마 피자 라지 28000원 레귤러 24000원 이에요 ?	
콤비네이션 피자 는 큰 건 에요 ?	큰 거 는 15900원 이요
레귤러 라지 에요 ?	라지 2만 원 이고 레귤러 는 18000원 입니다
콜라 작은 거 500 ml 는 에요 ?	콜라 작은 거 1500원 이고 큰 거 는 1800원 요
그러면은 3~4 인용 에요 ?	3~4 인용 기준 으론 26000원 이요
피자 끝 치즈 들어가고 그런 거 는 에요 ?	크 러스트 하시면 2000원 추가 요
피자 는 다 8000원 동일 금액 인가요 ?	아니에요 6000원 13000원 있어요
1.25 리터 한 병 은 에요 ?	2000원 이에요
고구마 피자 는 해 요 가격 이 ?	8000원 입니다
그거 는 가격 이 해 ?	라지 는 41000원 치즈 캡 안 하면 36500원 요
치즈 크 러스트 는 추가 하면 가격 에요 ?	슈림프 라지 하면 39400원 입니다
미디엄 은 에요 ?	피자 가격 이 다 다릅니다
새우 탕수육 작은 건 얼 만 데 요 ?	소자 이만 오천 원요
탕수육 은 에요 ?	만 오천 원요
나 홀로 세트 는 에요 ?	만 칠천 원요
깐 풍 육 운 죠 ?	25000원 이요
차돌박이 짬뽕 은 얼 만 데 요 ?	7000원 요
대자 는 에요 ?	대자 는 25000원 요
5000원 차이네요 ?	
유산슬 은 입 니까 ?	작은 건 30000원 큰 거 는 35000원 입니다
양장 피는 가격 이 해 요 ?	작은 거 는 30000원 이고요 큰 거 는 35000원 입니다
그냥 짜장 은 요 ?	5000원 이요
간짜장 이 더 비싸겠는데 에요 ?	6000원 이요
그거 는 가격 대가 ?	치즈 크 러스트 는 판다 삼천 원 추가 입니다
가격 은 인가요 ?	한 판 이만 사천구백 원 , 두 판 삼만 팔천구백 원 입니다
에요 ?	만 사천구백 원 입니다
그래요 프라이드 플러스 슈프림 치킨 반반하면 죠 ?	19000원 이요
간장 치킨 가격 은 얼 만 데 요 ?	한 마리 종류 하나 만 하시면 만 구천 원 이고 한 마리 두 가지 맛 하시면 이만 원 입니다
가격 은 에요 ?	미디엄 은 14000원 라지 는 17000원 입니다
라지 는 가격 대 는 되나요 ?	라지 29500원 , 27500원 , 24900원 짜리 있습니다
한 판 은 가격 이 에요 ?	한 판 은 작은 거 14000원 입니다
작은 거 는 이고 큰 거 는 에요 ?	두 판 21000원 27000원 입니다
가격 은 ?	앞 에는 단가 있는 거 뒤 에는 무난 하게 많이 드시는 거 입니다
벌집 피자 는 라지 사이즈 는 지 요 ?	만 칠천 원 이에요
대자 두 개 죠 ?	이만 칠천 원 이요
사십 프로 할인 하면 인가요 ?	이만 구백사십 원 이요 큰 거
가격 은 있어요 ?	튀김 은 17000원 이고요 찜닭 은 20000원 입니다
순 살 도 마찬가지 요 가격 은 ?	아뇨 순 살 은 2천 원 추가 되세요
뼈 있는 건 에요 ?	소 중 대 나눠져 있거든요 소가 17000원 중 24000원 대 35000원 이요
그거 가격 이 에요 ?	만 팔천 원요
그것 도 가격 이 똑같아요 ?	빵 필요 없다고 하시면 치킨 만 하는 경우 에는 20900원 이고요 빵 이 들어가면 21900원 이고요
가격 은 요 ?	가격 은 22900원 입니다
프라이드 는 에요 ?	프라이드 하고 거 선택 하면 그것 도 19000원 입니다
가격 이 에요 인분 이고 ?	19000원 요 뭐 고등학생 은 세 명 먹더라고요
가격 대가 되나요 ?	21000원 한 마리 한 마리 반 은 29000원 입니다 .
가격 은 인가요 ?	뼈 는 22000원 이고요 순 살 은 24000원 이에요
양념 된 거 하고 안된 거 하고 프라이드 는 에요 ?	프라이드 는 18000원 , 양념 은 19500원 이요
퀵 빈랑 그게 없이 가격 이에요 ? 19000원 이었던가 17000원 이었던가	순 살 은 20000원 , 뼈 있는 거 는 18000원 입니다
매운 거 는 고추장 빨간색 들어간 거 . 그거 는 더 비싸요 ?	양념 이 비싸요
날개 하고 봉 그건 지 요 ?	간장 같으면 19000원 이고요 매운 거 는 20000원 입니다
콜라 는 요 ?	1.5 리터 짜 리 는 2500원 작은 거 는 1500원 이에요
포장 시 무 추가 하면 인가요 ?	500원 씩 추가 하시면 됩니다 .
프라이드 세 마리 하고 양념 두 마리 하면 죠 ?	프라이드 는 한 마리 12000원 이고요 양념 은 14000원 입니다 .
가격 대 는 있어요 ?	일반 짬뽕 은 6000원 이고 얼 큰이 하고 삼선짬뽕 은 8000원 씩이고 해물짬뽕 은 12000원 생굴 짬뽕 은 11000원 이에요
4 인 가족 이 먹을 수 있는 걸 짬뽕 이랑 섞여서 가격 대 는 정도 지불 해야 돼요 ?	짬뽕 두 개 나가고 미니 탕수육 세트 는 18000원 이에요
짬뽕 은 한 그릇 해 요 ?	짬뽕 은 5500원 요
그거 는 가격 이 에요 ?	35000원 씩요
세트 메뉴 된 거 는 가격 이 에요 ?	짜장면 두 개 있는 세트 메뉴 는 18000원 이에요
해물 짬뽕 세트 는 에요 ?	세트 하시면 24000원 요
정도 해 요 ?	해물짬뽕 보통 7500원 짜리가 있어요
중 자 는 에요 ?	중 자 는 2만 2천 원요
올랐어요 ?	설날 요
동구 는 걸어야 돼요 ?	1588-3082 입니다
카드 결제 할게요	감사합니다
현금 이 천 원 밖에 없는데 어쩌 죠 ?	천 원 은 현금 주시 고 이천 원 은 배달 원 계좌 이체 해주시 면 돼요
카드 결제 하겠습니다	감사합니다
카드 결제 가능하죠 ?	가능합니다
추가 요금 해서 카드 결제 할게요	쿠폰 사용 은 현금 결제 시 만 가능한 점 양해 바랍니다
그렇게 해서 갖다 주시 고 결제 는 카드 할게요	단말기 챙겨서 가겠습니다
만나서 카드 결제 할게요	16500원 입니다
배달 오시 면 카드 결제 할게요	알겠습니다
현금 결제 할게요	16000원 입니다
카드 결제 가능하죠 ?	가능합니다
허니 치킨 콤보 는 카드 결제 할게요	총 24000원 입니다
카드 결제 할게요	감사합니다
카드 결제 하겠습니다	할인 받으셔서 2만 7천 원 입니다
5만 원 권 인데 괜찮은가요 ?	상관없습니다
결제 는 카드 할 거 예요	한 30분 정도 기다리셔야 돼요
카드 결제 가능하죠 ?	카드 결제 가능합니다
카드 결제 할게요	
카드 결제 가능할까 요 ?	가능하세요
카드 결제 할게요	알겠습니다
카드 계산 해도 될까 요 ?	그럼요
현금 결제 해야 하나요 ?	
카드 할게요	30분 안 가져다 드릴게요
카드 결제 가능하죠 ?	가능합니다
카드 결제 할게요	알겠습니다
카드 결제 되죠 ?	가능합니다
카드 계산 하려고 하는데 가능한가요 ?	카드 계산 가능합니다
카드 결제 할게요	알겠습니다
계좌 이체 도 될까 요 ?	가능합니다
카드 결제 되나요 ?	
카드 결제 하겠습니다	카드 기계 갖고 가겠습니다
결제 카드 해도 될까 요 ?	그럼요
감사합니다 . 카드 결제 할게요 .	카드 결제 확인 했습니다 .
현금 결제 할게요	알겠습니다
카드 는 가능하죠 ?	가능합니다
애 학교 간식 잘 나가 ?	아무래도 애 이다 보 니까 달콤한 맛 간장 치킨 맛 순 살로 선호 하는 편이 에요
카드 도 결제 되지 ?	됩니다
지금 카드 되죠 ?	됩니다
카드 는 되죠 ?	카드 결제 가능하세요
카드 도 되죠 ?	카드 가능해요
결제 는 카드 하나요 현금 ?	카드 나 현금 이나 원하는 대로 하시면 됩니다
현금 하지 싶은데 자동 이체 면 되겠다	됩니다 .
카드 하는 거 하고 현금 하는 거 하고 똑같아요 ?	금액 은 똑같아요
계산 할 현금 하고 카드 만 돼요 ?	현금 밖에 안 돼요
계좌 불러주세요	우리은행 6543217891 입니다
짬뽕 국물 도 서비스 부탁드려요	넣어 드릴게요
짬뽕 국물 도 주실 수 있어요 ?	가능합니다
국물 먹고 싶어서 그러는데 짬뽕 국물 도 가져다주실 수 있으실까 요 ?	보내 드릴게요
짬뽕 국물 도 주시나요 ?	
짬뽕 국물 따로 주실 수 있나요 ?	. 따로 가능합니다 .
짜장면 국물 은 안 오죠 ?	국물 은 안 가지 요
치킨 무도 많이 가져다주세요	알겠습니다
단무지 많이 주세요	걱정 하지 마십 쇼
피클 도 많이 주세요	알겠습니다
치킨 무 두 개 부탁드려요	알겠습니다
양파 랑 단무지 많이 넣어주세요	알겠습니다
무 하나 추가 가능하죠 ?	가능합니다
단무지 많이 갖다 주세요	알겠습니다
치킨 무 넉넉히 보내주시고요	알겠습니다
피클 추가 해 주세요	음료 는 콜라 작은 거 나갑니다
단무지 더 가져다주세요	알겠습니다
. 무 많이 주세요 .	, 감사합니다 .
치킨 무 많이 가져다주세요	감사합니다
1 개 만 주세요	총 3만 원 입니다
단무지 많이 주시고요	아쉽지 않게 넣어 드릴게요
단무지 많이 가져다주실 수 있을까요 ?	그럼요
피클 은 서비스 주시나요 ?	2 개 드려요
단무지 더 많이 주시 면 안 돼요 ?	큰 거 한 개 씩 드릴게요
단 품 하고 피자 두 판 시키는 거 하고 차이 있나요 ?	피자 나 토핑 양 대해 서는 차이 없고요 . 가격 할인 해드립니다
스모크 통 다리는 오븐 구 운 건가 요 ?	고객 님 매운 양념 발라 오븐 구 운 메뉴 입니다
육개장 은 직접 안 끓였죠 ?	
숯불 굽습니까 ?	숯불 합니다
면은 수 타 에요 ?	아니요 요즘 수 타 는 없습니다
허니콤 보는 너무 달 지 않아요 ?	안 달아요 인기 는 제일 좋아요
그게 맛 이에요 ?	맛 은 표현 하기 참 어려워요
맵 죠 ?	
중화 비빔밥 은 덜 짜게 해주시 면 안 돼요 ?	
얼 큰 짬뽕 은 많이 매워요 ?	
매운 건 아니죠 ?	그렇게 매운 건 아닙니다 . 김치 볶음 김치 입니다
슈프림 요 근데 이 게 느끼하지는 않나요 ?	느끼한 맛 도 있어요
맵 지 않죠 ?	맵 지 않아요
거기 매운 거 밖에 없나요 ?	순한 도 있어요
초등학생 이 먹을 거 라서 순하게 해야 돼서	숯불 순한 맛 하시면 됩니다
맵거나 짜거나 이렇지는 않나요 ?	불고기 요 맵 지는 않고 짠 거 못 드시면 짤 수 있어요
맵 기는 정도 매운 정도 나 요 ?	순 살 같은 경우 에는 주 메뉴 순 살 어니언 파닭 이라고 나가는 게 있고요
얼 큰이 짬뽕 은 게 맵기 ?	똑같아요 삼선짬뽕 얼큰한 게 얼 큰이 짬뽕 이 거든요
덜 짜게 해도 해주실 수 있어요 ?	소스 덜 발라 드릴 수 있어요
근데 안 짜게 할 수 있을까요 ?	소스 더 적게 뿌려 드릴게요
짜지 않게 간 조절 이 되나요 ?	햄 이나 치즈 자체 염분 은 조절 이 불가해서 힘들 같습니다
근데 덜 짜게 해주실 수 있어요 ?	가능해요 덜 짜게 만들어 드릴게요
그래요 맵기 짜기 이런 거 조절 해달라고 말씀드리면 조절 도 가능한가요 ?	
그래요 맵기 정도 너무 짜거나 매우 면 조절 도 가능한가요 주문 하면 ?	저희 는 순한 맛 은 안 맵고요 보통 맛 은 매콤 하고 매콤 한 맛 은 많이 맵고요
근데 맛 달 지 않게도 되나요 ?	본사 내려오니까 안됩니다 .
전화번호 뭔가 요 ? 자꾸 전화기 바뀌는 바람	337-7103 요
위치 는 되세요 ?	영조 아파트 2 길 건너편 있어요
매장 위치 돼요 ?	반야월 이마트 맞은편 롯데 아파트 상가 2 층 이에요
위치 가르쳐 주시 면 내일 이나 사러 갈게요	구 열대 삼거리 건너편 만 촌지 구대 옆 있습니다
거기 월성 보성 이 맞죠 ?	
거기 위치 라 ?	서구청 맞은편 이에요
위치 쯤 되나요 ?	평리 이동 있는 평리 롯데 캐슬 있습니다
상가 있어요 ?	골목길 올라오시면 있어요
위치 돼요 ?	평리 4 동 청구 아파트 앞 있거든요
위치 예요 ?	대구 일 중학교 맞은편 보시 면 신협 건물 있는데요 오피스텔 건물 이에요 대성 신협 이라고 있는데 건물 2 층 있어요
거기 성화 맞죠 ?	맞습니다
거기 치킨 집 맞나요 ?	맞습니다 주문 도 드릴게요
거기 교촌치킨 맞나요 ?	교촌치킨 입니다
거기 교촌치킨 맞죠 ?	맞으니 말씀 해주세요
거기 치킨 집 맞나요 ?	맞습니다
거기 피자 집이죠 ?	전화 받았습니다
거기 국빈 관 이 죠 ?	국빈 관 입니다
거기 치킨 피자 파는 곳 이 맞나요 ?	세트 메뉴 있습니다
거기 북경반점 인가요 ?	말씀 하세요
피자 집 인가요 ?	맞습니다
중국 성 이 죠 ?	
갈비 통닭 집 인가요 ?	갈비 통닭 집 입니다
치킨 매장 인가요 ?	공공 치킨 입니다
거기 중국집 쓰촨 성 맞나요 ?	쓰촨 성 맞습니다
요리 반점 맞나요 ?	맞습니다
거기 피자 집이죠	피자 집 입니다
거기 크라 우드 치킨 맞죠 ?	맞습니다
거기 홍콩 반점 인가요	홍콩 반점 입니다
거기 킹왕짱 치킨 노 형 점 맞나요 ?	맞습니다 .
거기 치킨 이 죠 ?	맞습니다
BBQ 상암 점 맞죠 ?	맞습니다
거기 중국집 이 죠 ?	영일 반점 입니다
거기 성화 맞죠 ?	맞습니다
거기 중화 방이 죠 ?	맞습니다
중국집 인가요 ?	맞습니다
OO 반점 맞나요 ?	맞습니다
피자 집이죠 ?	피자 전문점 입니다
치킨 이 죠 ?	맞습니다
안 볼 피자 맞죠 ?	네네 맞습니다
중화요리 죠 ?	
거기 중국집 이 죠 ?	
비비큐 월성 점 이 죠 ?	
외 동점 입 니까 내 동점 입 니까 ?	내외 점 요
거기 하양 점 이지 요 ?	. 맞습니다 .
중국집 아닌가요 반점 ?	맞아요
수고 하십니다 반점 이 죠 ?	
피자 치즈 크 러스트 추가 시 추가 되나요 ?	1000원 추가 됩니다
추가 되나요 ?	천원 추가 됩니다
추가 비용 은 인가요	1000원 입니다
감자 튀김 사이즈 업은 인가요	500원 추가 하시면 가능합니다
콜라 사이 즈 업 면 가격 이 추가 되나요 ?	콜라 사이즈 업은 2000원 가능합니다 .
곱빼기 는 가격 이 추가 되나요 ?	1000원 추가 됩니다
닭 다리 로만 구성 된 메뉴 있나요 ?	프라이드 다리 스모크 통 다리 양념 다리 세 가지 있습니다
나가사키 짬뽕 판매 하나요 ?	나가사키 짬뽕 은 없고 홍합 짬뽕 은 있습니다
순 살 도 양념치킨 있나요 ?	그럼요
하프 피자 가능한가요 ?	가능합니다
음료 는 가지 있나요	3 가지 있습니다
음료수 는 게 있나요 ?	탄산음료 주스 커피 가능하십니다
메뉴 되나요 ?	프라이드 양념 반 반 세 가지 있습니다
프라이드 치킨 순 살로 도 가능한가요 ?	가능합니다만 1000원 추가 되어 19000원 입니다
프라이드 치킨 순 살 도 있나요 ?	아니요 프라이드 치킨 은 순 살이 없습니다
양념치킨 시키려고 하는데 매운 맛 도 있나요 ?	맛 조절 가능합니다 .
스파게티 도 있나요 ?	치즈 스파게티 미트볼 스파게티 있어요
뭐 콤비네이션 있죠 ?	콤비네이션 하고 비슷한 거 는 페퍼디언스 있습니다
콤비네이션 피자 뭐 있어요 ?	콤비네이션 피자 쫄깃쫄깃 한 일반 원형 피자 하고 바삭바삭한 슈프림 피자 있어요 네모 난 게 저희 매장 에서만 나오는 거 예요
13000원 짜리는 건데 ?	13000원 짜리는 킹 소세지 피자 라고 소시지 이 많이 들어가요
해물 짬뽕 은 ?	없어요
짬뽕 은 종류 있는데요 ?	짬뽕 은 일반 짬뽕 하고 차돌박이 짬뽕 두 가지 있습니다
탕수육 은 ?	탕수육 은 대 중 소 다 있습니다
요리 도 다 돼요 ?	요리 는 깐 풍 욱 하고 깐 풍 새우 칠리 새우 이 거 밖에 없습니다
요리 도 돼요 ?	요리 종류 도 다 됩니다
양장 피 같은 요리 도 있어요 ?	
요리 종류 도 있어요 ?	일반 메뉴 밖에 없어요
근데 초등학생 애 잘 먹나요 ?	먹을 수 있습니다
이 도 단 품 도 있나요 ?	라지 로는 만 천구백 원 입니다
치킨 도 있어요 ?	윙 이랑 봉 이라고 해서 사이드 나가는 거고 메인 메뉴 로는 없습니다
이 게 콤비네이션 인가요 ?	기본 콤비네이션 이 고요 이탈리안 치즈 입니다
두 개 하면은 ?	클래식 피자 두 판 세트 , 알파 세트 , 레귤러 피자 두 판 나오는 세트 입니다
슈프림 치킨 있죠 ?	있어요
뭐 뭐 있는데 ?	순한 맛 은 간장 있고 프라이드 있어요
종류 거 있나요 ?	치즈 크 러스트 리치 골드 신 팬 바이트 페이스트리 이렇게 있습니다
지금 종류 게 있나요 ?	종류 는 기초 적 인 거 다 있어요 콤비네이션 불고기 포테이토 고구마 고구마 무스
거기 벌집 피자 있던데 거 예요 ?	고구마 무스 벌집 모양 올라가는 거 예요
피자 있나요 ?	제일 많이 찾으시는 거 는 불고기 나 고구마 나 콤비네이션 베이컨 이렇게 가지 입니다
블랙 앵거스 뭐 예요 ?	고기랑 랍스터 볼 이 들어가 있어요
양념 이 거 거 있어요 ?	양념 은 프라이드 양념 간장 세 가지 있습니다
메뉴 거 게 있어요 ?	튀김 종류 하고 찜닭 하고 있습니다
단일 품목 한 개 배달 하는 거 예요 ?	뼈 있는 거 랑 순 살로 만 나눠져 있고요
종류 는 게 있나요 치킨 이 ?	프라이드 양념 간장 그런 거 있어요
찜닭 은 안 하죠 ?	저희 는 찜닭 메뉴 는 없습니다
치킨 종류 로는 게 있어요 ?	치킨 종류 요 저희 종류 많아가지고요
메뉴 이 있나요 ?	간장 하고 양념 이 제일 많이 나갑니다
지금 찜닭 종류 있나요 ?	안동찜닭 야채 찜닭 묵은지 찜닭 순 살 이렇게 있습니다
한 마리 순 살 치킨 인가요 ?	순 살 도 있고 순 살 은 닭 다리 살 만 들어가 있고요 뼈 는 한 마리 예요
찜닭 종류 있나요 ? 종류 로는 게 있어요 ?	저희 는 간장 양념 베이스 고요 뼈 랑 순 살 있어요
별다른 일 없으면 종류 는 뭐 뭐 있죠 ?	앱 이나 인터넷 굽네치킨 치시면 메뉴 다 나옵니다
양념 은 한 가지네요 ? 저번 자주 시켜 먹었었는데	양념 은 맞아요 한 가지 에요 순 살 은 보드라운 다리 살이 고요
지고 바 종류 가지 죠 ?	뼈 있는 거 있고 순 살 있고 종류 는 두 가지 소금 구이 나가고 그렇습니다
날개 하고 봉하 고 . 뭐 있나요 ?	날개 하고 봉하 고 닭 다리 들어간 게 있습니다
부위 별로 하는 거 는 없어요 ?	프라이드 는 안 합니다
저녁 손님 오면 시키려고 하는데요 . 프라이드 종류 는 가지 에요 ? 부위 가요 . 전체 닭 한 마리 만 하나요 ?	프라이드 는 한 마리 만 합니다
4 인 가족 이 시켜 먹으려고 하는데 짬뽕 시키나요 세트 메뉴 도 있나요 ?	명 이서 드실 거 면 세트 보다 탕수육 중 자 시키는 게 낫 죠
짬뽕 종류 는 게 있어요 ?	일반 짬뽕 얼 큰이 짬뽕 부을 짬뽕 해물짬뽕 전복 삼선짬뽕 있어요
메뉴 게 있어요 ?	중국집 있는 메뉴 는 다 돼요
데 보다 사이즈 더 커요 ?	기본 적 레귤러 는 두 분 세 분 까지는 드실 수 있고요 라지 는 3~4 인용 입니다
사이즈 는 가지 나와요 ?	레귤러 라지 두 가지 있습니다
사이즈 가지 있어요 ?	지금 사이즈 는 1~2 인용 인 커플 사이즈 하고 3~4 인용 인 패밀리 사이즈 있어요
메뉴 나와있는 스티커 하나 만 주세요	전단지 요
메뉴 순 살 도 있나요 ?	순 살 은 1000원 추가 됩니다
요즘 광고 하는 치킨 이 뭐 죠 ?	갈비 맛 치킨 입니다
치즈 크 러스트 가능한 피자 는 뭐 있나요 ?	페퍼로니 피자 하와 이안 피자 있습니다
사이드 메뉴 엔 뭐 있나요 ?	치즈스틱 핫윙 이 있습니다
이벤트 피자 는 라지 사이즈 인가요 ?	미디엄 사이즈 제공 됩니다
매운 양념 이 아이 먹기 매운가요 ?	매울 거 예요
요새 TV 광고 하는 메뉴 시키려고 하는데 해당 메뉴 명 이 뭐 죠 ?	볼케이노 치킨 입니다
맵 지는 않겠죠 ?	전혀 맵 지 않아요
고구마 피자 는 도우 두께 선택 이 되는가요 ?	도우 두께 는 한 종류 입니다 사이즈 도 라지 하나 있습니다
도우 도 얇고 두껍고 선택 이 되는가요 ?	요청 하시면 최대한 펴가지고 얇게 해드릴 수 는 있어요
사이즈 는 뭐 뭐 있어요 ?	레귤러 라지 있습니다
해물 불 짜장 은 거 예요 ?	해물 들어가는 간짜장 식 인데 매운 짜 잔 요
깐 풍 육 운 안주 에요 ? 식사 에요 ?	안주 에요
양념 이 깐풍기 양념 이랑 비슷한가 봐요 ?	깐 풍 양념 돼지고기 한 번 튀기고 다시 깐 풍 양념 한 번 더 볶아서 나갑니다
국물 없는 짬뽕 은 뭐 예요 ?	끼 가락국수 같은 겁니다
날개 하고 봉 은 뭐 예요 ?	사람 치면 어깨 팔꿈치 그것 도 날개 에요
날개 만 된 게 윙 인가요 ?	날개 하고 봉 들어있습니다
양념 된 거 는 부위 별로 있고요 ?	간장 만 하고 매운 맛 하고 두 개 있는데 그거 는 다리 하고 날개 만 된 도 있습니다
마찰 이 짬뽕 밥 은 돼지고기 들어가나요 ?	짬뽕 은 돼지고기 씩 들어갑니다
전복 들어가고 여러 가지 딴 도 들어가죠 ?	네네
전복 들어가는 거 는 특 해물 짬뽕 시켜야 돼요 ?	전복 짬뽕 시키면 전복 이 들어가죠
슈퍼 디럭스 랑 슈퍼 슈프림 이랑 뭐 달라 요 ?	토핑 차이 인데 슈퍼 슈프림 이 더 채소 많이 올라갑니다
원형 피자 랑 네모 난 거 는 달라 요 ?	원형 피자 는 흑 미 도우 라서 쫄깃쫄깃 하고요 네모 난 거 는 초벌 두 번 해서 바삭바삭해요
간짜장 하고 짜장면 하고 차이점 이 뭐 예요 ?	짜장 은 미리 볶아놓은 거고 간짜장 은 주문 받고 볶아서 나가는 겁니다
거기 비비큐 리지 널 프라이드 랑 황금 올리브유 차이 뭐 예요 ?	같은 겁니다
근데 칠리 탕수육 도 있고 사천 탕수육 도 있던데 게 나아요 ?	학생 은 칠리 좋아하고 일반 어른 분들 은 일반 탕수육 좋아합니다
군 만두 도 하나 추가 요	군 만두 하나 추가 하겠습니다
탕수육 작은 사이즈 하나 부탁드려요	탕수육 추가 해서 2만 원 입니다
윙 도 하나 갖다 주세요	윙 도 추가 해드릴게요
두 개 보내주세요	알겠습니다 총 42000원 카드 결제 해주시면 됩니다
공 깃밥 도 주문 이 되나요 ?	한 공기 당 천 원 이요
맞아요 짬뽕 한 개 추가 요	일반 짬뽕 한 개 추가 하시면 총 40000원 입니다
세트 2 번 콜라 도 갖다 주세요	콜라 는 그냥 서비스 드릴게요
허니 콤보 2 개 콜라 큰 거 하나 추가 해주세요	허니 콤보 2 개 콜라 큰 거 하나 알겠습니다
군 만두 도 하나 추가 요	군 만두 하나 추가 하겠습니다
감자 튀김 쿠폰 모아서 감자 튀김 도 주실 수 있나요 ?	감자 튀김 도 준비 해드리겠습니다
짬뽕 공 깃밥 추가 할게요	8500원 입니다
탕수육 세트 자장면 곱빼기 추가 되나요 ?	됩니다
공 깃밥 추가 하면 추가 돈 드려야 돼요 ?	하나 천 원 이에요
더해지나요 ?	5천 원 정도 추가 돼요
선생님 은 별도 시키려고요	선생님 거 는 고구마 라든지 포테이토 시키면 괜찮고 애 은 콤비네이션 이랑 불고기 랑 많이 나가요
치즈 없는 피자 주문 하면 할인 해주시나요 ?	치즈 가격 은 빼 드려요
라지 두 판 하면 할인 해주시나요 ?	따로 할인 되는 건 없습니다
요기 요로 주문 했는데 배달 할인 7000원 이 되나요 ? 어제 까지는 반 반 인데 오늘 7000원 그러는 거 같던데	요기 요로 주문 하시면 됩니다
프라이드 시킬 건데 요기 요 통 하면 50 프로 디시 된다 하던데	문의 는 저희 쪽 말고 요 기요 물어보세요
머스터드 는 안 주셔도 되거든요 가격 이 할인 되나요 ?	아니요 할인 같은 건 안되고요
무 빼면 가격 할인 이 안 되나요 ?	그렇게 안 돼요 정해진 가격 대로 받아야 돼요
허니 리지 널은 쿠폰 사용 되나요 ?	허니 리지 널은 쿠폰 사용 하시면 1000원 추가 됩니다
프라이드 치킨 은 쿠폰 결제 할게요	쿠폰 10 장 미리 준비 해주세요
스파게티 쿠폰 3 장 있는데 다 쓸 수 있나요 ?	아니요 쿠폰 은 주문 당 한 장만 쓸 수 있습니다
탕수육 쿠폰 쓸 수 있나요 ?	결제 시 주세요
콜라 하고 무료 조각 쿠폰 이런 거 3 개 있는데	하나 씩 사용 가능하세요
양념 반 리지 널 반 되나요 ?	됩니다
프라이드 반 양념 반 되나요 ?	가능합니다 .
순 살로 주문 하려고 하는데 뼈 있는 거 반 반 씩 가능할까 요 ?	순 살로 만 주문 이 가능하십니다 .
쿠폰 은 개 요 ?	2 개 시키면 3 장 씩 드려요
짜장면 2 개 배달 말고 찾으러 갈 건데 가면 되나요 ?	20분 뒤 오시 면 됩니다
너무 오래 걸리는데 방문 포장 가능하나요 ?	아뇨 배달 주문 만 합니다
방문 해서 가져가겠습니다	방문 포장 이 므 2000원 할인 됩니다
구매 해야 배달 가능한가요 ?	만 원 구매 하시면 배달 해드립니다
한 판 은 주문 이 불가능한가요 ?	아뇨 가능하세요
지금 주문 되나요 ?	
안녕하세요 주문 되나요 ?	하시면 됩니다
지금 짜장면 이랑 짬뽕 배달 되나요 ?	짬뽕 재료 다 떨어져서 짜장면 만 가능하세요
지금 배달 되나요 ?	가능합니다
지금 배달 되나요 ?	지금 됩니다
지금 배달 가능한가요 ?	가능합니다
지금 배달 되나요 ?	가능합니다
지금 배달 가능한가요 ?	가능하십니다
지금 배달 가능한가요 ?	가능합니다
지금 배달 되나요 ?	가능합니다
지금 배달 되나요 ?	가능합니다
배달 가능한가요 ?	주문 받겠습니다
지금 배달 가능한가요 ?	배달 가능합니다
피자 지금 배달 가능한가요	가능합니다
지금 배달 하시나요 ?	말씀 하세요
지금 배달 가능 인가요 ?	가능하세요
지금 배달 되나요 ?	11시 배달 됩니다
배달 도 되나요 ?	배달 도 해드립니다
지금 배달 가능합니까 ?	가능한데 주문 이 밀려있어서 이 걸려요
바쁜가 보네요	저녁 이라 주문 이 밀려있어요
주문 되나요 ?	가능합니다
지금 배달 가능한가요 ?	가능합니다 .
배달 가능한가요 ?	배달 됩니다
지금 배달 되나요 ?	
9시 넘었는데 지금 도 배달 되나요 ?	됩니다
지금 배달 되나요 ?	. 지금 가능합니다 .
거기 배달 되시지요 ?	배달 됩니다
외동 인데 배달 되나요 ?	
외동 배달 되나요 ?	가능하세요
지금 배달 돼요 ?	
열두 시 배달 은 돼요 ?	저녁 열두시 가능해요
배달 도 되고 ?	배달 됩니다
피자 배달 되나요 ?	
지금 배달 되나요 ?	
배달 가능한가요 ?	
수고 하십니다 지금 죄송하지만 배달 가능한가요	가능하십니다
지금 배달 가능한가요 ?	
지금 배달 되나요 ?	
수고 하십니다 반점 이 죠 배달 가능한가요 ?	
배달 되나요 ?	지금 끝났는데요 죄송해요
배달 가능한가요 ?	
수고 하십니다 죄송하지만 배달 되나요 ?	
지금 배달 가능한가요 ?	말씀 하세요
중국집 명성 누 죠 ? 배달 지금 가능한가요 ?	배달 가능합니다
배달 하고 포장 하고 가격 은 달라 요 ?	틀리죠
배달 비는 따로 있나요 ?	없습니다
요즘 배달 비 따로 있나요 ?	2천 원 있습니다
배달 비는 에요 ?	5000원 입니다
추가 되는 배달 비 있나요 ?	추가 되는 배달 비 없습니다
배달 비 있나요 ?	배달 비 2000원 입니다 .
배달 료 는 인가요 ?	2000원 입니다
배달 료 도 있죠 ?	돈 은 배달 료 500원 추가세요 .
배달 료 있어요 ?	배달 팁 500원 있어요 총 25200원 입니다
배달 료 도 따로 드려야 되는가요 ?	기본 적 배달 은 안 되고요 단체 배달 만 가능해요
퀵비 따로 드려야 되나요 ?	아뇨 배달 료 는 저희 부담 합니다
배달 료 있는 거 요 ?	홀 드시는 거 하고 배달 나가는 거 하고 가격 양 이 틀립니다
배달 료 는 받나요 ?	저희 는 없습니다
배달 료 따로 받아요 ?	
요기 배달 료 포함 인가요 ?	아니요
통닭 값 이랑 거기 다가 오천 원 더 들어간다는 거 죠 ?	
퀵 은 배송비 들어요 ?	퀵비 오천 원 들죠
배달 하면 배달 료 따로 있나요 ?	아뇨 따로 없는데 배달 하시면 이십 분 더 걸려요
배달 료 받는데요 ?	배달 비 거리 마다 다르고 기본 이천 원 이에요 .
배달 료 따로 받나요 ?	
배달 료 따로 받던데 배달 료 는 있나요 ?	저희 매장 은 현재 는 없습니다
배달 료 따로 받던데 받나요 ?	아뇨 똑같이 해 요
원대동 인데 주문 할 배달 비 드려야 되나요 ?	원대동 은 배달 비 천원 있습니다
배달 비 따로 있어요 ?	없습니다
배달 비 따로 드려야 되나요 ?	아뇨 배달 비는 따로 없습니다
배달 하면 배달 료 따로 붙나요 ?	배달 료 는 따로 없습니다
배달 비는 따로 드려야 돼요 ?	아니요 배달 비는 따로 없습니다
배달 비는 따로 드려야 되나요 ?	아니요 그런 거 없어요
배달 비는 따로 드려야 돼요 ?	아니요 그런 거 없어요
배달 비도 따로 내야 되나요 ?	배달 비는 없습니다
배달 걸리나요 ?	지금 주문 이 밀려서 40분 정도 걸릴 거 같아요
배달 은 걸리나요 ?	30분 40분 정도 걸릴 예정 입니다
배달 은 걸리나요 ?	30분 정도 걸립니다
배달 은 걸릴까 요 ?	지금 주문 이 밀려서 50분 정도 걸릴 같아요
배달 오는 데 걸리나요 ?	50분 정도 걸립니다
소 요 은 대략 정도 걸리나요 ?	지금 으로부터 50분 이내 배달 됩니다
걸릴까 요 ?	40분 정도 소요 됩니다
걸리나요 ?	30분 정도 걸려요
지금 주문 하면 쯤 배달 되나요 ?	30분 쯤 뒤 배달 됩니다
걸 주시 고 은 걸리죠 ?	한 20분 정도 걸립니다
30분 안 배달 가능할까 요 ?	신속한 배달 해드리겠습니다
배달 은 걸리나요 ?	30분 정도 걸릴 예정 입니다
그렇게나 많이 기다려야 해 요 ?	지금 배달 업체 도 비상 이에요
기다리면 될까 요 ?	1시간 30분 2시간 정도 될 거 같은데요
걸리나요 ?	40분 소요 됩니다
시 쯤 오실까 요 ?	1시간 30분 후 도착 해서 전화 드리겠습니다
치킨 한 마리 피자 한 판 주문 하면 걸리나요 ?	오늘 연휴 기간 이라 1시간 걸립니다
지금 주문 하면 걸려요 ?	40분 정도 걸립니다
30분 안 배달 되나요 ?	금방 가져다 드릴게요
걸리나요 ?	지금 주문 이 밀려있어서 30분 정도 걸리세요
걸리나요 ?	지금 한 20분 정도 소요 됩니다
배달 은 걸리나요 ?	30분 정도 걸립니다
은 정도 걸릴까 요 ?	대략 30분 정도 예상 해주세요
늦 수도 있어요 ?	죄송합니다 주문 이 밀려서요
지금 주문 하면 걸릴까 요 ?	40분 정도 소요 됩니다
걸리나요 ?	1시간 정도 예상 됩니다
피자 주문 하면 걸릴까 요 ?	1시간 정도 걸릴 거 같아요
은 걸릴까 요 ?	30분 정도 걸립니다
걸릴까 요 ?	지금 점심시간 이라 주문 이 밀려서 30분 정도 걸릴 같아요
걸릴까 요 ?	1시간 안 으로는 무조건 배달 됩니다
걸릴까 요 ?	1시간 이내 도착 합니다
그렇게나 오래 걸리나요	오늘 축구 때문 다른데도 다 비슷할 거 예요
걸려요 ?	한 30분 정도 요 ?
지금 배달 하면 걸리나요	50분 정도 걸립니다
음료 는 필요 없는데 걸려요 ?	30분 안 배달 갑니다
은 걸리나요 ?	40분 정도 걸립니다
정도 걸릴까 요 ?	30분 1시간 정도 걸리십니다
대충 걸리나요 ?	30분 정도 걸립니다
걸려요 ?	30분 정도 요
오시는데 걸리나요 ?	30분 정도 걸릴 같아요
배달 이 걸리나요 ?	40분 50분 정도 걸립니다
공덕동 배달 오시는데 분 정도 걸리나요 ?	20분 정도 걸려요
도착 하는 데 걸리나요 ?	40분 소요 예정 입니다 .
배달 소요 은 요 ?	30분 입니다
걸리나요 ?	한 25분 30분 걸릴 같아요
아직 배달 이 안 왔는데 쯤 도착 하나요 ?	방금 출발 해서 도착 예정 입니다 .
지금 주문 하면 걸리나요 ?	30분 정도 걸립니다 .
걸릴까 요 ?	30분 정도 기다리셔야 합니다 .
배달 은 걸리나요 ?	30분 내 가능합니다
걸릴까 요 ?	40분 정도 걸립니다
배달 은 걸리나요 ?	현재 30분 정도 예상 됩니다 .
지금 치킨 시키면 걸릴까 요 ?	주 문 량 이 많아서 1시간 30분 정도 걸릴 거 같습니다
대우 아파트 1 동 105 호 인데 배달 이 걸리나요 ?	30분 안 배달 됩니다
정도 걸릴까 요 ?	40분 정도 걸립니다 .
빨리 먹을 수 있나요 ?	약 삼십 분 걸립니다
라지 2 개 주문 하면 분 정도 걸려요 ?	지금 저희 앞 주문 이 있어서 이 걸릴 같습니다
은 정도 걸려요 ?	은 3~40분 정도 걸릴 수 있어요
배달 돼요 ?	지금 한 30분 안쪽 이 시 면 될 같아요
배달 다 해서 전화하면 분 걸려요 ?	미리 잡아 놓으시면 맞춰서 해드려요
양장 피는 전화하면 정도 걸리죠 ?	양장 피는 보통 30분 정도 걸려요
은 정도 걸려요 ?	배달 40분 정도 소요 돼요
한 10분 안 올 수 있는 거 죠 ?	
지금 시키면 올 수 있어요 ?	금방 갑니다
지금 오시 죠 ?	아니요 은 걸립니다 .
나가면 기다려야 되나요 ?	지금 주문 하시면 십오분 정도 걸립니다
배달 은 시 합 니까 ?	보통 열두 시 입니다
낮 시켜야 되거든요 , 배달 은 돼요 ?	나중 전화 주시 면 기사 불러서 합니다
불 갈비 치킨 은 이 걸려 ?	한 이십 분 걸립니다
주문 하면 은 쯤 걸려요 ?	한 3~40분 걸립니다
배달 오시는데 소요 되는 은 분 정도 에요 ?	지금 하시면 한 35분 40분 정도 걸릴 같습니다 .
주문 하면 분 정도 소요 돼요 ?	십오분 이 면 나와요
주문 하면 분 정도 조리 하나요 ?	십오분
주문 하면 침산동 한 분 걸려요 도착 하면 ?	넉 넉 잡 한 40분 빠르면 30분 이고요
그거 주문 하면 오는데 이 걸리나요 ?	50분 걸립니다
주문 하면 은 걸려요 ?	오늘 은 한 기다려야 됩니다
그래요 배달 하는데 소요 되는 걸려요 ?	저희 한 3-40분 걸려요
세 마리 하려면 분 걸려요 ?	시간대 마다 다 틀려요
한 여덟시 쯤 뭐 우선하려면 한 일곱시 반 하면 되나요 ?	손님 이 필요하신 지금 말씀 하세요 예약 해야지 맞추는 거고요 나중 주문 하면 한 이 걸릴 수도 있어요
배달 시 시 하시는데요 ?	아침 열시 반 저녁 여덟 시 요
최대한 빨리 부탁드립니다	알겠습니다
최대한 빨리 배달 부탁드립니다	알겠습니다
최대한 빨리 가져다주세요	금방 드릴게요
되도록 이면 빨리 가져다주세요	알겠습니다
20분 뒤 배달 해주세요	준비 하겠습니다
빠르게 부탁드립니다	알겠습니다
빨리 가져다주세요	20분 안 가져다 드릴게요
더 빨리 는 안 되나요 ?	앞 주문 이 완료 되는 대로 빨리 갖다 드리겠습니다
최대한 빨리 부탁드릴게요	알겠습니다
그릇 은 일회용 인가요	수거 하는 그릇 배달 해드립니다
짬뽕 배달 용기 오나요 ?	일회용 그릇 배달 합니다
배달 올 일회용 그릇 인가요 ? 접시 인가요 ?	꼭대기 층 은 식사 시키면 일회용 가고 안주 시키면 그릇 갑니다
일회용 그릇 보내나요 ? 접시 보내나요 ?	그릇 보내 드릴게요
접시 오시나요 일회용 오시나요 ?	그릇 갑니다
그릇 은 일회용 이에요 ?	일회용 용기 배달 료 2000원 부과 돼요
용기 플라스틱 이라서 뜨거운 거 넣으니까 그렇던데 종이 포일 같은 거 는 안 되나요 ?	우리 전체 적 나가기 때문 어쩔 수 없어요
성곡동 도 배달 되나요 ?	배달 됩니다
한강 아파트 A 동 303 호 인데 배달 오나요 ?	가능합니다
성복동 배달 되나요 ?	배달 됩니다
행복 아파트 배달 되나요 ?	배달 가능하세요
한강 주문 할 수 있나요 ?	배달 이 늦 수도 있어요
신사동 12 번지 인데 배달 되나요 ?	가능합니다
중계 2 동 상아 아파트 배달 되나요 ?	배달 합니다
배달 오면 그냥 문 앞 놓고 달라 고 전 해주세요	잘 전달 하겠습니다
00 아파트 인데 배달 가능한가요 ?	가능합니다
서울 마포구 공덕동 인데 배달 되나요 ?	배달 료 2500원 입니다
중산동 인데 배달 되나요 ?	50분 정도 걸려요
연세대학교 언더우드 관 배달 가능한가요 ?	주문 해주세요
성곡동 도 배달 되나요 ?	배달 됩니다
동인 데 배달 되겠죠 ?	가능합니다
동도 배달 되나요 ?	동도 배달 하고 있습니다
외동 배달 되나요 ?	가능하세요
달서구 두류동 성안 오피스텔 배달 되나요 ?	갑니다
외동 동 신 아파트 쪽 배달 되나요 ?	
해 요 ?	주위 에만 해 요
주문 하면 침산동 인데 배달 은 가능한가요 ?	
칠성동 1 가인데 배달 되나요 ?	칠성동 1 가는 안됩니다
도착 해서 전화 주시 면 1 층 내려가서 받을게요	최대한 빨리 배달 해드리겠습니다
배달 원 분 한테 오시 면 현관 전화 달라 고 해주세요	전 하겠습니다
집 아기 자고 있어서 배달 오면 1 층 전화 주시겠어요 ?	알겠습니다
오셔서 010-1234 - 5678 연락 한 통 부탁드릴게요	연락 드리겠습니다
배달 출발 할 전화 주실 수 있나요 ?	. 전화 드리겠습니다 .
치킨 이 가장 맛있나요 ?	켄터키 치킨 이 제일 잘나가요
치킨 이 제일 잘나가요 ?	매운 양념치킨 이 제일 잘나갑니다
요즘 맛있다고 하는 메뉴 추천 해 주세요	자메이카 통달 이 구이 인기 있습니다
피자 메뉴 게 잘 나가나요 ?	슈 림프 피자 인기 좋습니다
치킨 이 가장 맛있나요 ?	프라이드 치킨 이 가장 잘 나가요
요즘 많이 나가는 게 뭐 예요 ?	지금 더블 크 러스트 이 베리 코피 자 제일 잘나가요
고구마 피자 말고 거 뭐 잘 나가요 ?	블랙 타이거 슈 림프 피자 블랙 앵거스 피자 입니다
프라이드 더 잘 나가요 ? 양념 이 더 잘 나가요 ?	양념 이 많이 나갑니다
게 잘 나가요 ? 요즘	슈프림 인기 많아요
황금 올리브 치킨 이나 그냥 반 반 시키려고 하는데 게 더 잘 나가요 ?	그거 는 둘 다 제일 잘나가는 거 예요
잘 나가는 거 거 있어요 ?	대표 메뉴 킹 스페셜 고구마 나 치즈 바이트 , 무난 하게 불고기 고구마 포테이토 화이트 콤비 , 매콤 한 거 좋아하시면 핫 불고기 고구마 있습니다
세트 메뉴 는 게 잘 나가요 ?	세트 는 먹는 양 다른데 훈제 치킨 들어가는 도 있고 스파게티 들어가는 도 있고 다 틀려요
피자 중 게 잘 나가나요 ?	고구마 나 불고기 제일 많이 나가거든요
피자 종류 중 게 잘 나가나요 ?	7 번가 스페셜 이나 체다 골드 나 깐 쇼 불 갈비 많이 나갑니다
게 제일 잘나가나요 ?	고구마 하고 불고기 제일 잘나갑니다
피자 잘 나가요 ?	새로 나온 블랙 앵거스 많이 나갑니다
찜닭 한 마리 잘 나가는 종류 뭐 있나요 ?	간장 된 양념 빨간색 된 양념 두 가지 순 살 있어요
주로 잘 나가는 메뉴 있어요 ?	달달 하고 궁 중 4 번 세트 라고 궁 중 하고 다달이 제일 잘나갑니다
추천 해 주세요	보통 저희 뼈 닭 같은 경우 에는 투 펀치 반 만 반 이라고 그게 나눠서 세 가지 맛 이 들어가요
한 세트 19000원 요 종류 말고 거 뭐 잘 나가는 거 뭐 있어요 ?	프라이드 여러 가지 많이 있어요
주로 뭐 잘 나가요 ? 빨리 나올 수 있는 요리 있나요 ?	유산 슬 팔보채 양장 피 이런 거 고급 음식 이라 잘 나갑니다
주로 거 시키나요 사람 이 ?	주로 밥 종류 는 짬뽕 짜장면 간짜장 잡채 밥 볶음밥 이렇게 시키세요
짬뽕 이나 간짜장 중 게 잘 나가나요 ?	는 배달 하는 사람 이라서 그건 잘 모르겠네요
주로 게 잘 나가요 ?	탕수육 짜장 이나 짬뽕 세트 잘 나가죠
짬뽕 류 는 게 있나요 ? 잘 나가는 짬뽕 있나요 ?	특 해물 짬뽕 도 있고 전복 새우 짬뽕 도 있고 해물 종류 도 새우 홍합 전복 없는 게 없습니다
제일 빨리 나오는 게 짬뽕 이에요 ?	일반 짬뽕 이 제일 빨리 나오죠
잘 나가고 빨리 오는 짬뽕 종류 는 메뉴 거 예요 ?	볶아 놓은 걸 드리는 게 아니고 바로바로 볶기 때문 짬뽕 종류 는 똑같아요
컵 같은 데 다가 메인 메뉴 말고 사이드 메뉴 하나 있는 거 같던데 ?	피자 끝 올라가는 라고는 일곱 개 더 드리는 겁니다
콜라 작은 거 큰 거 변경 가능한가요 ?	가능하지만 1000원 추가 요금 있습니다
콜라 는 사이 즈 업 해주세요	음료 사이즈 업 시 1000원 추가 됩니다
3 번 세트 메뉴 자장면 곱빼기 변경 되나요	변경 됩니다
콜라 사이즈 업도 가능하죠 ?	
짜장면 곱빼기 가능할까 요 ?	. 가능합니다 .
양념 소스 만 더 챙겨 주신다 온누리 상품권 도 돼요 ? 김해 온누리상품권	아니요 저희 는 안됩니다
온누리 상품권 결제 도 돼요 ? 온누리 상품권	상품권 같은 건 안 돼요 고객 님 현금 이나 카드 결제 밖에 안됩니다
소스 자체 섞어져 있는 거 군 요 . 상품권 온누리 상품권 돼요 ?	안됩니다
그래요 온누리 상품권 도 되나요 ?	안됩니다
그렇구나 뭐 온누리 상품권 도 결제 돼요 ?	안 돼요
현금 결제 할 건데 서비스 있나요 ?	군 만두 서비스 드릴게요
군 만두 도 서비스 가져다주세요	단골 이신 데 당연하죠
피자 라지 콜라 서비스 오나요 ?	아니요 콜라 는 따로 주문 해주세요
콜라 나오나요 ?	500 ml 하나 서비스 드립니다
콜라 서비스 인가요 ?	콜라 는 세트 메뉴 시키셨을 만 무료 제공 됩니다
서비스 있나요 ?	군 만두 있습니다
콜라 도 주시나요 ?	메뉴 포함 됩니다
콜라 는 제공 되나요 ?	1 마리 주문 시 500 ml 콜라 제공 됩니다
샐러드 서비스 되나요 ?	1 개 기본 이고 추가 시 2000원 입니다
콜라 도 주시나요 ?	콜라 는 주문 하셔야 됩니다
주문 하면 피클 하고 뭐 주시나요 ?	피클 하나 , 갈릭 소스 하나 , 핫 소스 하나 이렇게 갑니다
여기는 피클 하고 그런 거 는 뭐 요 ?	피클 하나 , 파 마산 하나 , 핫 소스 두 개 , 음료 500 ml 기본 갑니다
핫 소스 같은 건 안 나오겠네요 ?	핫 소스 파 마산 어니언 소스 도 나가요
콜라 나 피클 같은 건 뭐 주세요 ?	콜라 는 따로 추가 해야 하고 피클 은 기본 나갑니다
음료수 따로 나옵니까 ?	콜라 는 따로 사셔야 돼요
서비스 는 없습니까 ?	콜라 , 음료수 정도 드릴 수 있어요
음료수 는 되 ?	음료수 는 따로 시키셔야 됩니다
피클 은 많이 주시 면 안 돼요 ?	피클 기본 한 개 나가는데 추가 당 800원 이고 작은 피클 은 500원 입니다
콜라 는 주는 건가 요 ?	아니요 따로 주문 하셔야 돼요
오이 피클 은 주나요 ?	피클 은 기본 두 개 나갑니다
콜라 는 주나요 ?	음료 는 별도 주 문 이세 요
깐 풍 육 대자 시키면 서비스 뭐 주시나요 ?	서비스 만두 나가고 안 좋아하시면 콜라 하나 드립니다
서비스 는 뭐 주세요 ?	소주 음료수 콜라 짬뽕 국물 중 선택 하시면 됩니다
양장 피 35000원 짜리 하면은 거 뭐 주시나요 ?	만두 서비스 요
모자라 요 콜라 는 추가 오나요	콜라 는 별도 입니다
음료수 는 서비스 오는 게 있나요 ?	500 미리 콜라 나가요
무는 나가는 거 따로 없죠 ?	무는 한 개 나갑니다
음료수 는 안 나와요 콜라 ?	한 마리 하시면 500 미리 나갑니다
소스 는 뭐 뭐 나옵니까 ? 프라이드	양념 소스 하나 머스터드 하나요
양념 은 뭐 뭐 나오나요 ? 양념 이 아니라 소스 나오는 사이드 있잖아요 허니 머스터드 콜라 무 이런 거	메뉴 마다 소스 들어가는 게 다 틀려요
나올 소스 는 뭐 뭐 왔었죠 ? 소스 허니 뭐 있더라	소스 소금 구이 할 는 머스터드 소스 나갑니다 .
무도 오는 거 아닌가요	무는 갑니다
허니 스파클링 . 콜라 아니에요 ?	콜라 는 따로 구매 하셔야 돼요
음료수 도 오지 요 ?	기본 음료수 는 허니 스파클링 나가요
포장 에는 따로 요	그렇죠
거 는 추가 더 사야 한다고요 ?	소스 같은 건 500원 씩 구입 하셔야 돼요
12000원 프라이드 값 소스 소금 나가고 포장 하면 뭐 있어요 ?	소금 밖에 안 나가요
그렇구나 배달 에는 무하 고 콜라 하고 들어가고요 ?	다섯 마리면 콜라 는 들어가는데 고 깃값 도 비싸고 퀵 있어요 더 비싸죠
한 개당 한 마리 씩 요 저희 그니까 무는 필요 안 거든요 무 빼면 콜라 바꿔주실 수 있나 해서요	아니요 콜라 못 바꿔 드리죠
무 빼고 콜라 바꿔주실 수 는 있어요 ?	그런 거 는 안되세요 고객 님
선 결제 하고 문 앞 두고 가주실 수 있나요 ?	미리 결제 해주시면 그렇게 해 드리겠습니다 .
결제 는 미리 하고 갈 건데 요 ?	결제 는 미리 해주세요
불고기 피자 치킨 세트 프라이드 치킨 오는 건가 요 ?	맞습니다
세트 3 번 시키려고 하는데 짜장 2 탕수육 1 맞나요	손님 맞습니다
중간 사이즈 두 개 짜 리도 있나요 ?	작은 거 요
세트 시키면 서비스 오는 게 있나요 ?	군 만두 서비스 있습니다 .
세트 시켜야 되나요	
짬뽕 이랑 볶음밥 이랑 탕수육 세트 있나요 ?	죄송하지만 없습니다
세트 메뉴 는 없어요 ?	짜장면 이랑 탕수육 세트 있습니다
피자 는 종류 고기 종류 나눠지나요 ?	고기 , 해산물 , 파인애플 , 감자 , 고구마 콤비네이션 , 고 기류 피자 , 해산물 , 매콤 한 도 있습니다
그렇게만 있나요 ? 세트 메뉴 도 있나요 따로 ?	아뇨 저희 는 세트 메뉴 없어요 따로
세트 메뉴 도 있어요 짬뽕 들어간 세트 메뉴 ?	짬뽕 두 개 들어간 세트 메뉴 있어요
세트 메뉴 는 따로 ?	세트 메뉴 도 있어요
, 세트 묶어주세요 !	, 알겠습니다 .
세트 2 번 짜장면 하나 짬뽕 바꿔도 되나요 ?	500원 추가 하시면 됩니다
, 세트 묶으면 할인 되는 거 죠 ??	마리 당 천 원 총 2000원 할인 되네요 .
저희 는 머스터드 는 안 먹어서 머스터드 는 빼고요 . 매운 소스 는 핫 소스 말씀 하시는 건가 요 ?	
소스 는 근데 뭐 뭐 나오죠 ?	소스 는 매운 소스 하고 머스터드 소스 나와요
어린이 포크 도 있나요 ?	저희 는 포크 는 없습니다
젓가락 3 개 보내주세요	챙겨 드릴게요
소주 도 한 병 부탁 합니다	알겠습니다
콜라 는 따로 주문 해야 하나요 ?	작은 콜라 서비스 드리고 있습니다
갈비 맛 치킨 순 살로 부탁드립니다	40분 정도 소요 될 같습니다
치킨 주문 하려고 하는데요	말씀 하세요
스모크 통 다리 하나 랑 콜라 큰 거 주문 할게요	콜라 일 점 이 리터 추가 하시면 추가 금액 이 천오백 원 발생 됩니다
양념치킨 이랑 간장 치킨 순 살로 주문 가능한가요 ?	순 살 가능합니다
자장면 1 개 짬뽕 1 개 주문 할게요	자장면 1 개 짬뽕 1 개 12000원 입니다
순 살 치킨 도 가능한가요 ?	순 살 은 오늘 매진 됐어요
치즈볼 가져다주세요	치즈볼 은 200원 추가 됩니다
이벤트 피자 핫윙 10조 배달 부탁드립니다	등록 되어있는 주소 1시간 안 배달 해 드리겠습니다
짬짜면 하나 랑 짬뽕 하나요	만 원 입니다
양념치킨 주세요	16000원 입니다
지금 치킨 주문 가능한가요 ?	가능합니다
걸 주문 할게요	금방 배달 해드릴게요
일반 짜장면 2 개 홍합 짬뽕 1 개 배달 부탁드려요	배달 은 30분 정도 소요 되세요
자메이카 통달 이 구이 하나 콜라 1 리터 주문 할게요	한 40분 정도 소요 됩니다
그냥 프라이드 치킨 두 마리 해주세요	프라이드 준비 해 드릴게요
양념치킨 두 마리 요	죄송한데 지금 프라이드 만 주문 가능하신데요
짜장면 1 그릇 배달 해주세요	1 그릇 만 배달 하면 배달 비도 계산 해주셔야 해 요
세트 1 번 갖다 주실 수 있나요 ?	가능합니다
지금 볼케이노 치킨 한 마리 주문 가능할까 요 ?	죄송합니다 지금 은 볼 게 이 논 소스 품절 이 되어서 메뉴 주문 부탁드립니다
짜장면 짬뽕 울면 하나 씩 이랑 탕수육 소자 주문 할게요	알겠습니다
짜장면 하나 탕수육 중 하나 짬뽕 두 개 하려고 해 요	탕수육 중 짜장면 하나 짬뽕 둘이요
크림소스 스파게티 하나 랑 치킨 양념 반 리지 널 반 갖다 주세요	30분 정도 걸릴 겁니다
짜장면 1 개 랑 짬뽕 곱빼기 1 개 배달 되나요 ?	가능합니다 .
치킨 주문 하려는데요	말씀 해주세요
프라이드 2 마리 부탁드립니다 .	30분 정도 걸릴 거 같아요 .
프라이드 1 마리 반도 가능할까 요 ?	죄송합니다 . 저희 는 반 마리 는 판매 안 해서요 .
짜장면 하나요	죄송하지만 만 원 배달 가능합니다
탕수육 주세요	. 대신 만두 서비스 드릴게요 .
짬뽕 이랑 깐풍기 배달 해주세요 .	깐풍기 는 재료 다 떨어졌습니다 .
제일 큰 거 한판 주세요	패밀리 한판 주문 입니다
기본 하나 곱빼기 하나 가져다주세요	알겠습니다
매장 위치 되시는 거 예요 ?	신 서 혁신도시 비전 스퀘어 맞은편 은행 있는 건물 뒤편 있습니다
500원 짜리 하나 만 더 주세요	기본 한 개 작은 피클 한 개 추가 하시고요
그게 라지 사이즈 인 거 죠 말씀 하시는 게 ?	
짜장면 오이도 들어가나요 ?	오이랑 완두콩 다 들어갑니다
이 베리 코 포크 돼지고기 인가요 ?	스페인 돼지고기 요
치즈 에요 ?	최고급 임실 치즈 에요
새우 탕수육 은 새우 만든 거 예요 ?	새우 튀긴 겁니다
깐 풍 육 운 닭고기 하나요 ?	아니요 돼지고기 입니다
피자 치즈 는 뭐 써요 ?	모차렐라 치즈 자연 산 치즈 입니다
뭐 들어가죠 ? 슈프림	하얀 소스 입니다
밀가루 반죽 이 얇은가요 ?	두껍지 않습니다
불 갈비 는 돼지고기 돼 있나요 ?	소고기 입니다
안 닭고기 하고 야채 는 거 들어가요 ?	야채 는 당근 이랑 감자 랑 양파 랑 이런 거 들어가고요 떡 이랑 당면 들어가요
닭고기 는 국내 산 쓰나요 ?	국내 산입 니 다
뭐 야채 는 게 들어가요 사장 님 ?	전화 계속 들어오기 때문 설명 못 드리거든요 책자 보면 다 나와 있어요
피자 옆 치즈 테두리 들어가는 거 는 ?	치즈 들어가면 가격 은 더 세져요
그거 는 도우 두께 정 할 수 있나요 ?	정 할 수 있어요
블랙 앵거스 는 거 들어가지요 ?	고 깃 덩어리 들어가면서 랍스터 살이 들어가요
가공 한 거 요 고기 자체 아니고	이 거 는 가공 해가지고 들어간 거 라서 가격 은 2만 원대 고요
불고기 피자 는 뭐 들어가요 ?	불고기 피망 버섯 하고 양파 불고기 이렇게 들어가고요
도우 두께 나 그런 거 는 요 ?	그거 는 정 하실 수 있어요
슈퍼 수프림 은 위 뭐 들어가요 ?	슈퍼 수프림 은 피망 햄 이 전체 적 깔리면서 옥수수 파인애플 들어가고요
도우 두께 라든지 치즈 는 ?	저희 도우 는 얇은 편 인데 리지 널은 얇고 치즈 크 러스트 는 빵 끝 치즈 들어가서 도톰하고요
해산물 은 거 들어가요 ?	홍합 하고 바지락 하고 여러 가지 넣어요
지금 안 들어가는 게 돼지고기 죠 ?	
쟁반 끼 가락국수 해물 이 거 들어가는지 여쭤 보려고 하는데	는 잘 몰라요
고 기 짬뽕 은 돼지고기 들어가나요 ?	고 기 짬뽕 은 돼지고기 고 차돌박이 짬뽕 은 소고기 고요
지금 전단지 보고 전화 드리는 건데 삼선짬뽕 들어가는 해물 은 거 있어요 ?	새우 시작 해서 여러 가지 들어가요
해물짬뽕 거 들어가요 ?	해물 여러 가지 들어가요
탕수육 들어가는 고기 돼지고기 죠 ?	집 이든지 다 돼지고기 입니다
큐브 피자 인가 ? 새로 나온 거 예요 ?	나온 지 됐습니다
위치 는 쯤 되세요 ?	효성 타운 하고 반야월 사이 있어요
배달 앱 도 있는가 ?	배달 앱 은 안 돼요
도 배달 민족 하는 거 예요 ?	
앱 주문 도 할 수 있나요 ?	앱 으로도 주문 가능하세요 배달 민족 있고요
앱 배달 하면 할인 되고 그런 거 있어요 ?	앱 배달 하는 거도 다 똑같이 통신사 나 삼 성 카드 할인 이 돼요
소스 는 별도 구매 인가요 ?	, 별도 구매 입니다 .
소스 추가 구매 하고 싶어요	매운 양념 마요네즈 머스터드 소스 준비 되어있습니다
찍어 먹을 양념 소스 도 주세요	알겠습니다
치킨 무는 빼고 소스 바꿀 수 있을까요 ?	소스 는 추가 결제 하셔야 합니다 .
혼자 피자 한판 먹을 수 있을까요 ?	저희 피자 맛있어서 가능합니다
3 명 이 먹기 엔 부족할까 요 ?	성인 3 명 이 먹기 엔 부족할 수 있습니다
어린아이가 한 그릇 다 먹을 수 있나요 ?	적당합니다
4 학년 23 명 먹을라 카면은 판 정도 하면 되나요 ?	초등학생 이면 한 판 두세 명 이 먹으면 맞아요
라지 사이즈 조각 들어가죠 ?	12 인치 박스 8조 들어가요
시키면 1.25 리터 인가 ?	
라지 한판 조각 나와 ?	10조 나옵니다
피자 3 명 이 먹을 건데 사이즈 는 거 하면 좋겠어요 ?	라지 하나 하시면 될 거 예요 많이 드시면 미디엄 두 판 하셔도 되고요
35000원 이면은 한 인분 정도 될까 요 ?	35000원 은 4 사람 정도 28000원 은 두세 사람 정도 요
사이즈 는 한 사이 즙 니까 ?	양장 피 소자 28000원 대자 35000원 두 가지 있습니다
중 자 명 정도 먹을 수 있나요 ?	서너 명 이 요
탕수육 은 사이즈 있어요 ?	소 중 대로 11000원 13000원 16000원 이렇게 있어요
퐁듀 붉은 피잔 구 ? 그거 라지 사이즈 는 명 먹을 수 있어요 ?	삼사 인용 입니다 . 여덟 조각 두 조각 씩 먹으면 명 먹을 수 있습니다
갈릭 스테이크 라지 는 명 정도 먹는데요 ?	두 조각 씩 먹으면 명 이서 먹습니다
잘 몰라서 카는데 초등학교 일학년 되는 애 은 그거 시키면 명 이 먹어요 ?	명 정도 먹을 수 있다고 보시 면 돼요
4 인 가족 이 먹으려면 뭐 시켜야 돼요 ?	라지 여덟 조각 나가긴 나가는데 작은 여덟 조각 이에요
4 인 가족 이 먹으려면 라지 한 판 가능할까 요 ?	성인 같으면 명 먹기 는 모자랄 겁니다
4 인 가족 이 먹으려고 하는데 사이즈 는 정도 주문 해야 되나요 ?	라지 하시면 되세요
벌집 피자 는 명 정도 먹을 수 있어요 ?	한두 세명 정도 요
라지 한 판 명 정도 먹을 수 있어요 ?	보통 라지 사이즈 는 여덟 조각 나오거든요 . 사람 마다 드시는 양 이 다르다 보 니까
가격 대가 한 4 인 가족 이 먹으려면 걸 시켜야 돼요 ?	찜닭 튀김 닭 하면 됩니다
4 인 이 먹으려고 하는데 한 마리 시키면 돼요 ?	한 세트 하면 돼요
그게 기준 이 2 , 3 인분 인가요 ?	순 살 같은 경우 에는 2 , 3 인분 하고 뼈 닭 같은 경우 에는 3 , 4 인분 두 마리 에요
명 이 먹을 수 있어요 ?	그게 두 마리 예요
3 인 가족 이 먹으려고 하면 시켜야 하나요 ?	한 마리 먹어야 합니다 2만 천 원 입니다
4 인 가족 이 먹으려고 하면 걸 시키면 되나요 ?	한 마리 시키면 돼요
그거 는 인분 이에요 ?	주로 술안주 드시기 때문 명 정도 드실 수 있어요
그거 시키고 거 시켜야 돼요 ?	
탕수육 이 4 인 가족 이 먹을 수 있나요 세트 메뉴 시키면 ?	탕수육 보통 이 17000원 인데 그거 시키는 게 나을 거 같아요
4 인 이 먹을 수 있을까요 ?	명 드시 기 엔 세트 양 이 적어요 명 드시려면 탕수육 중 자 는 가야 죠
엘지 멤버십 할인 되나요 ?	죄송한데 저희 는 그런 거 안 돼요
지금 영업 하고 계시나요 ?	영업 중 입니다
시 시 영업 하시는데 ?	보통 문 는 12시 12시 반 이고 저녁 은 10시 합니다
영업 은 시 하시는데 ?	11시 저녁 10시 해 요
배달 은 시 돼요 ?	원래 12시 하는데 오늘 은 9시 까지요
배달 은 시 되나요 ?	열시 반 됩니다
수고 하십니다 죄송하지만 배달 시 시 하시나요 ?	저희 이 오전 에는 열한시 고요 저녁 마감 은 한 신 데 보통 한 12시 한 40분 정도 되면 끝나요
수고 하십니다 죄송하지만 배달 시 시 하나요 ?	우리 열두시 열한시 해 요
죄송하지만 영업 은 시 시 하세요 ?	열시까 집니다 아침 열한시 밤 열시
수고 하십니다 뭐 여쭤 볼 게 있는데요 배달 이 시 시 인가요 ?	저희 열한시 반 열한시 까진 데 요
배달 시 시 ?	배달 은 열한 시 해 요
내일 주문 미리 예약 할 수 있나요 ?	죄송합니다만 당일 예약 만 가능합니다
배달 시키려 하는데 배달 말고 예약 배달 가능한가요 ?	시 까지라고 말씀 해주시면 가능하세요
면 점심때 들어가려면 전날 전화 드려야 되겠다 그러지 ?	예약 해놓으면 맞춰서 보내 드리죠
지금 결제 해놓으면 이따가 배달 해주실 수 있죠 ?	
일곱 , 여덟 , 아홉 판 정도 주문 하려면 쯤 전화 드리면 되지 ?	한 40분 정도 전 전화하시면 돼요
이 곳 개점 이 요 ?	오전 10시 입니다
시 해 요 ?	오전 열한 시 입니다
오픈 은 시 해 요 ?	열두 시 에요
시 오픈 하세요 ?	열한 시 요
거기 낮 시 오픈 내일 ?	낮 열두 시 요
오픈 이 돼 ?	열두 시 저녁 열두 시 해 요
저희 토요일 놀러 갈 하려고 하는데 아침 시 문 열어요 ?	내일 열두시 엽니 다
아침 시 문 열어요 ?	일요일 이 쉬는 날 이에요 .
불고기 는 소고기 쓰나요 ? 한우 국산 이에요 ?	호주 산입 니 다
닭고기 는 국내 산 쓰나요 ?	네네 국내 산이 에요
불고기 는 국내 산 은 아니죠 ?	그런 건 아니고 갈아가지고 동글동글 하게 만들어놨어요
탕수육 돼지고기 국산 이 죠 ?	는 잘 모르겠습니다
국내 산 쓰나요 수입품 쓰나요 ?	국내 산 써요
전부 국산 이에요 ?	돼지 는 국산 이고 차돌박이 는 미국 산이 에요
국내 산 쓰나요 ?	돼지고기 는 다 국내 산입 니 다
콜라 하나 만 추가 해주세요	알겠습니다
콜라 도 가져다주세요	알겠습니다
1 리터 콜라 한병도 가져다주세요	3만 원 되겠습니다
콜라 하나 추가 해주세요	22500원 입니다
콜라 1 개 추가 할게요	감사합니다
사이다 큰 사이즈 부탁드려요	금방 배달 해드리겠습니다
콜라 큰 사이즈 되나요 ?	아니요 콜라 는 큰 사이즈 없습니다
콜라 도 작은 거 하나 주세요	알겠습니다
콜라 는 따로 주문 해야 하나요 ?	아니요 서비스 나갑니다
종류 있나요 ?	콜라 , 사이다 , 환타 , 레모네이드 있습니다 .
500 짜리 하나 주세요	500 짜 리 요
콜라 작은 거 두 개 주세요	
페트병 인가요 ?	페트병 이 요
음료수 는 돼요 ?	음료수 는 따로 추가 하셔야 됩니다
음료수 는 따로 주문 해야 되지요 ?	두 판 하시면 금액 이 3천 원 이 할인 되고 콜라 하나 나가거든요
작은 게 하나 따라오고 큰 거 는 추가 비용 내야 되는 거 죠 ?	
페트병 은 인가요 ?	1800원 이요
콜라 추가 로는 예요 ?	콜라 큰 게 2000원 이거든요 사이다 도 2000원 이고요
콜라 도 추가 주문 하면 배달 해주시는가요 ?	원래 기본 작은 게 나가고 천원 추가 하시면 사이즈 업그레이드 해드려요
너무 오래 걸리는데 빨리 부탁드릴게요	알겠습니다
전단지 있는 만 원 이벤트 아직도 진행 중 인가요 ?	진행 하고 있습니다
사이드 메뉴 할인 행사 하나요	지금 진행 중인 행사 는 없습니다
후기 이벤트 아직도 진행 하시나요 ?	갈릭 소이 치킨 한해 서 진행 중 입니다
이벤트 할 거 면 충분한 양 가지 고 판매 하셔야 되는 거 아닌가요 ?	평소 보다 재료 2 배 정도 준비 했는데 워낙 많은 분 이 주문 하셔서 금방 소진 되었습니다
먹고 나서 후기 작성 할 테 니 감자 튀김 도 부탁드리겠습니다	맛있게 해서 금방 가져다 드릴게요
리뷰 쓰면 서비스 있나요 ?	있습니다 .
후기 쓴다고 하면 감자 튀김 서비스 주시 는 거 맞죠 ?	
가에 치즈 크 러스트 들어가는 도 선택 이 되 ?	그럼요
쿠폰 사용 하려고 하는데요	치킨 만 쿠폰 가능하고 소스 는 별도 지불 하셔야 해 요
쿠폰 사용 이 가능한가요 ?	이벤트 중이 라 쿠폰 사용 은 불가능하세요
쿠폰 40 장 모았는데 사용 가능한가요 ?	가능합니다
쿠폰 은 장 모으면 쓸 수 있어요 ?	30 장모 이 면 음식 하나 공짜 드려요
배달 민족 보 니까 쿠폰 있던데 그거 는 써요 ?	그건 어플 상 선 결제 할 쓰실 수 있는 쿠폰 이에요
쿠폰 은 쓰는데요 ?	나중 콜라 주문 하실 콜라 쿠폰 쓸 거 라고 말씀 해주고 배달 해주시는 기사 님 한테 쿠폰 전 해주시면 됩니다
그거 10 개 모으면은	5 개 모으면 사이드 나가고 8 개 모으면 리지 널 미디엄 피자 12 개는 리지 널 라지 피자 이렇게 나가거든요
쿠폰 준다고도 되어 있던데 조건 이 되는 거 예요 ?	배달 갈 마다 금액 맞게 드리는데 모아 두셨다가 나중 쓰시 면 돼요 . 주문 하실 미리 말씀 해주셔야 돼요
젓가락 은 대나무 젓가락 주시나요 ?	아니요
젓가락 은 대나무 젓가락 사용 해 주시나요 ?	아니요 그런 건 안 씁니다
제휴 카드 추가 할인 은 안되죠 ?	중복 할인 은 안됩니다
제휴 카드 추가 할인 은 안 돼요 ?	중복 할인 은 안 돼요
종이컵 도 따로 오는 가요 ?	아뇨 종이컵 은 따로 없는데 없으면 종이컵 한 줄 나가면 돼요
순 살로 부탁드릴게요	주문 감사합니다
콜라 말고 사이다 주세요	사이다 바꿔서 드리겠습니다
이태원동 260 번지 인데 2 인 탕수육 세트 갖다 주세요	2 인 탕수육 세트 이만 원 입니다
주문 할게요 주소 는 A 아파트 104 동 102 호 입니다	A 아파트 104 동 102 호 요
서울대학교 병원 1 층 안내 센터 배달 가능한가요 ?	가능합니다
서울특별시 강서구 105-12 번지 배달 해주세요	지금 은 점심시간 라 40분 정도 는 기다리셔야 돼요
저희 집 현관 비번 3434 이에요	알겠습니다
동그라미 아파트 103 동 103 호 인데 요	103 동 103 호 요
안녕하세요 동산 아파트 203 동 201 호 요 .	주문 하세요 .
주소 는 팔팔 171 입니다	감사합니다
OO 아파트 OO 동 OO 호에 짬뽕 하나 배달 되나요 ?	짬뽕 하나 배달 가능합니다
주소 는 서울시 성동구 성수동 1 99-99 1001 입니다	감사합니다
대성 스카이 백이 동 천오백삼 호 인데 우리 고구마 피자 배달 되죠 ?	
대성 스카이 렉스 백이 동 천오백삼 호 인데 프라이드 한 마리 만 배달 해주세요	배달 거기 안 합니다
주차장 있나요 ?	건물 뒤 있어요
주차 는 옆 도로 변 되는가 ?	싣고 나가실 수 있게 포장 해 놓을게요
주차 는 하면 돼요 ?	아파트 상가 주차장 하시면 됩니다
밥 반찬 먹으면 어떨까 요	괜찮습니다
아이 도 먹을 수 있나요 ?	매울 수 는 있는데요
아이 먹기 피자 좋을까요 ?	콤비네이션 피자 불고기 피자 추천 드려요
어깨 피자 카 는 게 있는데 야채 많이 들어간 거 는 거 예요 ?	어깨 피자 는 야채 많이 안 들어가요 이 거 는 9 가지 토핑 맛 볼 수 있게 되어있는 겁니다
초등학생 고학년 은 피자 종류 잘 나가요 ?	초등학생 은 고구마 , 포테이토 , 불고기 , 콤비네이션 이렇게 많이 나가요
선생님 은 따로 한 판 까 싶은데 선생님 거 는 거 나가요 ?	치즈브러썸 이라고 치즈 많이 들어가고 안 창살 들어간 거 추천 드려요
고등학생 간식 피자 거 잘 나가요 ?	학생 은 포테이토 나 슈 림프 골드 그런 거 잘 나가요
양장 피하 고 비슷한 거 뭐 있어요 ?	고추 잡채 팔보채 유산슬 도 있어요
애 초등학생 뭐 좋아하는데요 ?	갈릭 스테이크 도 괜찮고요 , 치킨 바비큐 콤비네이션 도 있습니다
새우 나 육류 좋아해요	새우 들어가는 건 블랙 타이거 슈 림프 있고 고기 많이 들어가는 글램핑 바비큐 피자 있어요
초등학교 3 학년 인데 피자 추천 하는 메뉴 있어요 ?	보통 기본 적 인 피자 에서는 불고기 슈퍼 수프림 많이 나가고 있어요
선생님 은 거 많이 나가죠 ? 어른 좋아하는 거	선생님 은 체더치즈 나 리치 골드 해서 하나 는 포테이토 하나 는 고구마 좋아하시거든요
종류 는 게 많이 나가나요 ? 여자 선생님 이 거든요	선생님 은 보통 고구마 나 새우 들어가는 블랙 타이거 슈림프 도 있고 고기 랍스터 살 들어가는 블랙 앵거스 도 있고요
4 인 가족 이면 탕수육 하나 딴 거 거 시켜요 ?	짜장면 짬뽕 해물짬뽕 사람 마다 좋아하시는 게 다 달라 요
카카오 페이 나 삼성 페이도 되나요 ?	카카오 페이 는 안되고 삼 성 페이 는 됩니다
카카오 페이 는 결제 되는가요 ?	그거 는 본인 이 인터넷 들어가셔서 하셔야 합니다
지금 주문 하려는데요 영업 이 시 인가요 ?	저희 매장 은 새벽 3시 영업 합니다
거기 시 영업 하나요 ?	밤 10시 영업 합니다
시 주문 가능한가요 ?	새벽 1시 가능합니다 .
주문 시 전화 받으세요 ?	10시 가능하세요
여긴 시 해 요 ?	11시 30분 주문 받습니다
시 문 닫나요 ?	9시 반 이나 10시 쯤 되면 닫을 같습니다
시 하세요 ?	9시 까지요
시 문 닫아요 ?	8시 반 요
시 마쳐요 ?	8시 합니다
시 하세요 ?	마지막 주문 이 9시 에요
수고 하십니다 죄송하지만 배달 은 시 하나요 ?	열두시 열한시 요
저녁 에는 시 하나요 ?	저녁 에는 내일 일찍 마쳐야 돼서 한 열시 밖에 안 합니다
시 배달 하시는데요 ?	보통 한 20분 정도 되면 끝냅니다
시 문 닫아요 ?	보통 은 한 여덟 시 정도 닫아요
배달 시 해 요 ?	지금 시키셔야 돼요
9시 전화하면 돼요 ?	대부분 8시 반 주문 받습니다
주문 전화 는 시 해야 되나요 ?	8시 반 주문 받아요
주문 전화 시 해야 되는데요 ?	8시 배달 해드릴 수 있습니다
마지막 주문 은 시 하면 돼요 ?	마지막 주문 이 9시 여서 전 결제 하시면 됩니다
슈 림프 핫 치킨 골드 피자 이건 치킨 이에요 ?	이 거 는 새우 핫 치킨 , 베이컨 , 브로콜리 올라가는 거 예요
불고기 피자 에는 고기 많이 들어가고 ?	그거 는 불고기 들어가는 건데 콤비네이션 과는 고기 다르게 생겼고 야채 는 똑같이 들어가요
콤비네이션 에는 뭐 뭐 들어가요 ?	콤비네이션 에는 올리브 햄 페퍼로니 야채 많이 들어가고 팝핑 이라고 불고기 들어가요
토핑 이 거 올라가요 ?	모차렐라 치즈 , 리 코타 , 로마노 크림 치즈 , 콰트로 치즈 퐁듀 , 규 크 럼블 , 베이컨 , 돼지고기 , 고구마 무스 , 감자 , 마요네즈 , 토마토소스 , 선 드라이 토마토 , 코코넛 허니 버터 파우더 이 베리 코 포크 이렇게 들어갑니다
목동 피자 는 게 들어가요 ?	목동 피자 는 야채 , 페퍼로니 하고 특별한 햄 , 치즈 올라가요
그거 는 위 토핑 이 뭐 들어가는 거 예요 ?	새우 랑 들어갑니다
치즈 크 러스트 위 토핑 이 뭐 있어요 ?	치즈 크 러스트 는 테두리 부분 치즈 들어가는 입니다
위 토핑 이 뭐 올라가요 ?	불고기 소고기 하고 볶음 김치 하셨습니다
골라요 거 거 있어요 ?	콤비네이션 불고기 페퍼로니 하와 이안 치즈 야채 고구마 무스 포테이토 화이트 콤비 핫 불고기 고구마 이렇게 있습니다
토핑 은 위 거 얹어지나요 ?	토핑 은 고르시면 됩니다
토핑 은 야채 나 이런 은 게 올려져 있나요 ?	양파 나 여러 가지 기본 야채 브로콜리 그런 게 다 들어갑니다
토핑 은 걸 되어있나요 ?	그거 는 선택 하시는 거 예요 다 14000원 똑같습니다
모든 피자 토핑 추가 안되는 거 예요 ?	그렇게는 안되는 걸 알 고 있어요
불고기 피자 는 기본 불고기 들어갈 거고 토핑 이 올라가죠 ?	피망 이랑 옥수수 랑 스모크 햄 같은 게 올라가요
불고기 는 안 올라가요 ?	
벌집 피자 고구마 말고는 토핑 은 게 올라가요 ?	일반 적 올라가는 옥수수 나 피망 올리브 스모크 햄 이런 식 올라가요
오이 빼주실 수 있으세요 ?	가능합니다
매운 짬뽕 은 아주 맵 게 해서 주세요	더 맵게요
치즈 랑 포테이토 추가 토핑 해주세요	포테이토 피자 파티 사이즈 우리 밀 도우 치즈 포테이토 추가 토핑 맞죠 ?
치즈 없는 피자 만들어주실 수 있나요 ?	가능합니다
청양고추 빼주시면 안 돼요 ?	청양고추 는 안 들어가지만 베트남 고추가 들어가서 많이 맵습니다
토핑 종류 여러 가진데 한 판 여러 개 주문 해도 되나요 ?	한 판 2 개 가능하고 , 원래 가격 2천 원 추가 됩니다
불고기 피자 에는 토핑 더 추가 할 수 있나요 ?	아니요
벌집 피자 불고기 추가 해서는 주문 못 하나요 ?	그렇게는 안 돼요
포장 은 인가요 ?	프라이드 포장 이 12000원 이에요 , 무는 500원 씩이고요
직접 찾으러 가면 할인 되나요 ?	, 2000원 할인 됩니다 .
배달 료 따로 받던데 매장 받으면 가요 ?	저희 는 매장 할인 이 따로 있습니다
저희 가지러 가면	할인 없습니다
배달 하고 가지러 가면 가격 더 할인 되죠 ?	할인 되는 건 없습니다 저희 는 콜라 대 짜 드립니다
가서 가지러 가면 요 ?	30 프로 됩니다
찾으러 가는 게 할인 많이 되네요 ?	금액 이 크면 할인 이 많아요
전화 하는 거나 앱 하는 거나 똑같은 거 예요 ?	통신사 카드 없을 경우 할인 이 안되고요 찾으러 오셔야 할인 이 됩니다
할인 혜택 같은 건 있어요 ?	어플 하시면 할인 혜택 이 있어요
쿠폰 이나 할인 혜택 같은 건 있나요 ?	평상시 쿠폰 이 가고 배달 민족 주문 하시면 더 저렴할 거 예요
할인 같은 건 없고요 ?	따로 없어요
두 판 뭐 그런 거도 있어요 ?	지금 원형 피자 행사 하고 있어요 두 판 해서 19900원 입니다
KT 하면 할인 프로 되는데 ?	KT 는 20 프로 입니다
할인 카드 나 적립 카드 는 있습니까 ?	통신사 제휴 카드 는 할인 이 되고 적립 은 따로 없어요
배달 앱 하면 더 저렴한가요 ?	배달 앱 할인 받으면 저희 측 에서는 할인 이 다 안됩니다
SK VIP 인데 할인 되죠 ?	30 프로 됩니다
할인 적용 되는 건 있어요 ?	그런 건 따로 없는 알 고 있어요
40 프로 하는 게 끝났나요 ?	끝났습니다
근데 사십 프로 할인 하는 거 맞죠 ?	사십 프로 그거 는 포장 만 할인 됩니다
요즘 거기 피자 사십 프로 하고 있던데 맞아요 ?	포장 하러 오셔야 해 요
피자 사십 프로 행사 하고 있던데 맞아요 ?	포장 하시면 사십 프로 할인 되고 도 미노 홈페이지 들어가셔서 주문 해주셔야 합니다
할인 은 됩니까 ?	할인 하면 보통 통신사 카드 15 프로 씩 다 되고요 SK vip 있으면 30 프로 되고요
통신사 카드 없이는 할인 안되는가요 ?	신용카드 로는 삼 성 카드 나 포인트 있을 경우 에는 30 프로 되고요 현 대 카드 는 포인트 있으시면 50 프로 되고요
할인 쿠폰 이 있는데 사용 할 수 있습니까 ?	쿠폰 20 프로 할인 행사 진행 중 입니다
위메프 오늘 구매 한 맞쵸킹 천 원 권 쓸 수 있나요 ?	고객 님 죄송합니다만 맞쵸킹 은 오늘 재료 소진 판매 끝났습니다
할인 쿠폰 이 있는데 사용 가능한가요 ?	, 사용 가능합니다 .
포인트 적립 하고 이런 거 는 없고요 ?	
근데 요 적립 은 따로 안 돼요 ? 번 시켜 먹어 봤는데	적립 은 없고 쿠폰 나갑니다
할인 쿠폰 이나 적립 카드 이런 건 있어요 ?	저희 피자 박스 쿠폰 이 달려있거든요
이번 주 일주일 간 매일 한다던데 아닌가요 ?	그건 지난주였고요 이번 주는 없습니다
매일 행사 ?	오늘 화요일 만 하고 있습니다
일주일 간 한다던데요	그건 저번 주 끝났고요 매주 화요일 마다 인터넷 하시면 사십 프로 할인 합니다
할인 행사 해 요 ?	매주 화요일 하고 있어요
현금 영수증 해주세요	번호 찍어주세요
현금영수증 되나요 ?	배달 원 분 께 알려주시면 가능하십니다
현금 영수증 도 해주세요	전화번호 알려주세요
현금 하면 할인 되고 그런 도 있나요 ?	그런 건 따로 없습니다
깐 풍 익 가지러 가면 가격 은 가요 ?	가게 와서 갖고 가시 면 22000원 요
레귤러 는 ?	구천구백 원 입니다
서는 얼 만 데 요 ?	만 천구백 원 입니다
홀 에서도 먹을 수 있나요 ?	
나 저희 직접 가서 먹을 수 있는 자리 도 있나요 ?	저희 는 홀 도 있어요
오늘 영업 하나요 ?	영업 하고 있습니다 .
일요일 도 하세요 ?	열두시 열두시 합니다
토요일 은 하세요	토요일 한시 거든요
